102434111110
110044444400
000000044440
000200000000
000020000000
000201021000
000000000002
001002000010
001000000040
000005000000
000000000000
000002000104
