111110011111
111115000001
111100011001
044101011011
000002001211
100101000011
111100011211
111111111001
111140000001
111111111111
111111111111
111111111111
