111110011111
111115000001
111100011001
004121011011
000000001011
100101000011
111100011011
111111111001
111100000001
111111111111
111111111111
111111111111
