111110011111
111115000001
111100020401
004121010001
000000000011
100101000011
111100011011
111111111001
111100000001
111111111111
111111111111
111111111111
